25
20
0000000000300000000000000
0000000000300000000000000
1110000003300000000000000
0111000003000000000000000
0112021333000000000000000
0002223300000000000000000
0000222200000000000000000
0000000000000000000000000
0000000000000000000000000
0000000000000000000000000
0000000000000000000000000
0000000000000000000000000
3000000000000000000000000
3300000000000000000000000
0330000000200000000000000
0033100002220000000000000
0003000000200000000000000
3333000000000000000000000
0000000011110000000000000
0000000111000000000000000