10
5
0322000011
3300000011
3000000000
3000000000
0000000000